Cool Boarders	/wiki/Cool_Boarders

Crash Bandicoot (video game)	/wiki/Crash_Bandicoot_(video_game)

Everybody's Golf 2	/wiki/Everybody%27s_Golf_2

Syphon Filter	/wiki/Syphon_Filter

Tekken 2	/wiki/Tekken_2

MediEvil (video game)	/wiki/MediEvil_(video_game)

Jumping Flash!	/wiki/Jumping_Flash!

Rally Cross	/wiki/Rally_Cross

Jet Moto (video game)	/wiki/Jet_Moto_(video_game)

2Xtreme	/wiki/2Xtreme

Destruction Derby	/wiki/Destruction_Derby

Wipeout (video game)	/wiki/Wipeout_(video_game)

Castlevania: Symphony of the Night	/wiki/Castlevania:_Symphony_of_the_Night

Spyro the Dragon (video game)	/wiki/Spyro_the_Dragon_(video_game)

Twisted Metal 2	/wiki/Twisted_Metal_2

Wild Arms	/wiki/Wild_Arms

Warhawk (1995 video game)	/wiki/Warhawk_(1995_video_game)

Crash Bandicoot 2: Cortex Strikes Back	/wiki/Crash_Bandicoot_2:_Cortex_Strikes_Back

Jet Moto 2	/wiki/Jet_Moto_2

Crash Bandicoot: Warped	/wiki/Crash_Bandicoot:_Warped

Jet Moto 3	/wiki/Jet_Moto_3

R-Type and R-Type II (compilations)	/wiki/R-Type_and_R-Type_II_(compilations)

Syphon Filter 3	/wiki/Syphon_Filter_3

Rayman (video game)	/wiki/Rayman_(video_game)

Street Fighter Alpha	/wiki/Street_Fighter_Alpha

Sno-Cross Championship Racing (page does not exist)	/w/index.php?title=Sno-Cross_Championship_Racing&action=edit&redlink=1

Castlevania Chronicles	/wiki/Castlevania_Chronicles

Rayman 2: The Great Escape	/wiki/Rayman_2:_The_Great_Escape

Suikoden (video game)	/wiki/Suikoden_(video_game)

Bowling (Playstation game) (page does not exist)	/w/index.php?title=Bowling_(Playstation_game)&action=edit&redlink=1

R-Type Delta	/wiki/R-Type_Delta

Spyro 2: Ripto's Rage!	/wiki/Spyro_2:_Ripto%27s_Rage!

Spyro: Year of the Dragon	/wiki/Spyro:_Year_of_the_Dragon

The King of Fighters '99	/wiki/The_King_of_Fighters_%2799

Ford Racing (series)	/wiki/Ford_Racing_(series)#Ford_Racing

Tom Clancy's Rainbow Six (video game)	/wiki/Tom_Clancy%27s_Rainbow_Six_(video_game)

Resident Evil (1996 video game)	/wiki/Resident_Evil_(1996_video_game)

Final Fantasy VII	/wiki/Final_Fantasy_VII

Medal of Honor (1999 video game)	/wiki/Medal_of_Honor_(1999_video_game)

Street Fighter Alpha 2	/wiki/Street_Fighter_Alpha_2

Medal of Honor: Underground	/wiki/Medal_of_Honor:_Underground

Metal Gear Solid	/wiki/Metal_Gear_Solid

Gunbird	/wiki/Gunbird

Spec Ops (series)	/wiki/Spec_Ops_(series)

XS Junior League Soccer (page does not exist)	/w/index.php?title=XS_Junior_League_Soccer&action=edit&redlink=1

Spec Ops (series)	/wiki/Spec_Ops_(series)

Spec Ops (series)	/wiki/Spec_Ops_(series)

Wild Arms 2	/wiki/Wild_Arms_2

Spec Ops (series)	/wiki/Spec_Ops_(series)

Dead in the Water (video game) (page does not exist)	/w/index.php?title=Dead_in_the_Water_(video_game)&action=edit&redlink=1

Ten Pin Alley	/wiki/Ten_Pin_Alley

Tomb Raider (1996 video game)	/wiki/Tomb_Raider_(1996_video_game)

Bloody Roar (video game)	/wiki/Bloody_Roar_(video_game)

Cool Boarders 2	/wiki/Cool_Boarders_2

SimCity 2000	/wiki/SimCity_2000

Tomb Raider II	/wiki/Tomb_Raider_II

Cool Boarders 3	/wiki/Cool_Boarders_3

Blood Omen: Legacy of Kain	/wiki/Blood_Omen:_Legacy_of_Kain

Silent Hill (video game)	/wiki/Silent_Hill_(video_game)

Syphon Filter 2	/wiki/Syphon_Filter_2

Final Fantasy Tactics	/wiki/Final_Fantasy_Tactics

Tomb Raider III	/wiki/Tomb_Raider_III

Gex 3: Deep Cover Gecko	/wiki/Gex_3:_Deep_Cover_Gecko

Jumping Flash! 2	/wiki/Jumping_Flash!_2

Nuclear Strike	/wiki/Nuclear_Strike

UmJammer Lammy	/wiki/UmJammer_Lammy

Pandemonium (video game)	/wiki/Pandemonium_(video_game)

Tomb Raider: The Last Revelation	/wiki/Tomb_Raider:_The_Last_Revelation

Oddworld: Abe's Exoddus	/wiki/Oddworld:_Abe%27s_Exoddus

Oddworld: Abe's Oddysee	/wiki/Oddworld:_Abe%27s_Oddysee

Gex (video game)	/wiki/Gex_(video_game)

Command & Conquer: Red Alert	/wiki/Command_%26_Conquer:_Red_Alert

Legacy of Kain: Soul Reaver	/wiki/Legacy_of_Kain:_Soul_Reaver

Resident Evil 2	/wiki/Resident_Evil_2

Backstreet Billiards (page does not exist)	/w/index.php?title=Backstreet_Billiards&action=edit&redlink=1

Command & Conquer (1995 video game)	/wiki/Command_%26_Conquer_(1995_video_game)

Dino Crisis	/wiki/Dino_Crisis

Fighting Force	/wiki/Fighting_Force

International Track & Field	/wiki/International_Track_%26_Field

Reel Fishing (video game)	/wiki/Reel_Fishing_(video_game)

Command & Conquer: Red Alert – Retaliation	/wiki/Command_%26_Conquer:_Red_Alert_%E2%80%93_Retaliation

Resident Evil 3: Nemesis	/wiki/Resident_Evil_3:_Nemesis

Bomberman Party Edition	/wiki/Bomberman_Party_Edition

Final Fantasy VIII	/wiki/Final_Fantasy_VIII

Wing Commander IV: The Price of Freedom	/wiki/Wing_Commander_IV:_The_Price_of_Freedom

Championship Bass (page does not exist)	/w/index.php?title=Championship_Bass&action=edit&redlink=1

Extreme Pinball	/wiki/Extreme_Pinball

Hi-Octane	/wiki/Hi-Octane

Dirt Jockey: Heavy Equipment Operator (page does not exist)	/w/index.php?title=Dirt_Jockey:_Heavy_Equipment_Operator&action=edit&redlink=1

Populous: The Beginning	/wiki/Populous:_The_Beginning

Theme Park World	/wiki/Theme_Park_World

Magic Carpet (video game)	/wiki/Magic_Carpet_(video_game)

Mass Destruction (video game)	/wiki/Mass_Destruction_(video_game)

Sorcerer's Maze (page does not exist)	/w/index.php?title=Sorcerer%27s_Maze&action=edit&redlink=1

Grandia (video game)	/wiki/Grandia_(video_game)

Jigsaw Madness	/wiki/Jigsaw_Madness

One (video game)	/wiki/One_(video_game)

Perfect Weapon (video game) (page does not exist)	/w/index.php?title=Perfect_Weapon_(video_game)&action=edit&redlink=1

Hardcore 4X4	/wiki/Hardcore_4X4

Airboat Racing (page does not exist)	/w/index.php?title=Airboat_Racing&action=edit&redlink=1

XS Junior League Dodgeball (page does not exist)	/w/index.php?title=XS_Junior_League_Dodgeball&action=edit&redlink=1

XS Moto (page does not exist)	/w/index.php?title=XS_Moto&action=edit&redlink=1

Star Wars: Dark Forces	/wiki/Star_Wars:_Dark_Forces

Bomberman Fantasy Race	/wiki/Bomberman_Fantasy_Race

Delta Force: Urban Warfare	/wiki/Delta_Force:_Urban_Warfare

N2O: Nitrous Oxide	/wiki/N2O:_Nitrous_Oxide

Bloody Roar 2	/wiki/Bloody_Roar_2

Final Fantasy IX	/wiki/Final_Fantasy_IX

Motor Toon Grand Prix 2	/wiki/Motor_Toon_Grand_Prix_2

A Bug's Life (video game)	/wiki/A_Bug%27s_Life_(video_game)

Disney's Hercules (video game)	/wiki/Disney%27s_Hercules_(video_game)

The Emperor's New Groove (video game)	/wiki/The_Emperor%27s_New_Groove_(video_game)

Toy Story Racer	/wiki/Toy_Story_Racer

Crash Team Racing	/wiki/Crash_Team_Racing

Theme Hospital	/wiki/Theme_Hospital

Soviet Strike	/wiki/Soviet_Strike

Cho Aniki	/wiki/Cho_Aniki#Cho_Aniki_-_Kyuukyoku_Muteki_Ginga_Saikyou_Otoko

Gaia Seed (page does not exist)	/w/index.php?title=Gaia_Seed&action=edit&redlink=1

Outlaws of the Lost Dynasty	/wiki/Outlaws_of_the_Lost_Dynasty

Magical Drop	/wiki/Magical_Drop

Alundra	/wiki/Alundra

Arc the Lad (video game)	/wiki/Arc_the_Lad_(video_game)

Shienryu	/wiki/Shienryu

Tall Unlimited (page does not exist)	/w/index.php?title=Tall_Unlimited&action=edit&redlink=1

Virtual Pool 3	/wiki/Virtual_Pool_3

Sonic Wings Special	/wiki/Sonic_Wings_Special

Money Idol Exchanger	/wiki/Money_Idol_Exchanger

Arc the Lad II	/wiki/Arc_the_Lad_II

Arc the Lad Collection	/wiki/Arc_the_Lad_Collection

Blockids (page does not exist)	/w/index.php?title=Blockids&action=edit&redlink=1

Dezaemon Plus! (page does not exist)	/w/index.php?title=Dezaemon_Plus!&action=edit&redlink=1

Galaxy Fight: Universal Warriors	/wiki/Galaxy_Fight:_Universal_Warriors

Front Mission 3	/wiki/Front_Mission_3

Arc the Lad III	/wiki/Arc_the_Lad_III

Re-loaded (page does not exist)	/w/index.php?title=Re-loaded&action=edit&redlink=1

Metal Slug X	/wiki/Metal_Slug_X

Mega Man (video game)	/wiki/Mega_Man_(video_game)

Mega Man 2	/wiki/Mega_Man_2

Harvest Moon: Back to Nature	/wiki/Harvest_Moon:_Back_to_Nature

Super Gem Fighter Mini Mix	/wiki/Super_Gem_Fighter_Mini_Mix

Reel Fishing II	/wiki/Reel_Fishing_II

Destrega	/wiki/Destrega

Romance of the Three Kingdoms IV: Wall of Fire	/wiki/Romance_of_the_Three_Kingdoms_IV:_Wall_of_Fire

Saiyuki: Journey West	/wiki/Saiyuki:_Journey_West

Xenogears	/wiki/Xenogears

Vagrant Story	/wiki/Vagrant_Story

Lilo & Stitch: Trouble in Paradise (page does not exist)	/w/index.php?title=Lilo_%26_Stitch:_Trouble_in_Paradise&action=edit&redlink=1

Monsters, Inc. Scare Island	/wiki/Monsters,_Inc._Scare_Island

Peter Pan: Adventures in Never Land	/wiki/Peter_Pan:_Adventures_in_Never_Land

R4: Ridge Racer Type 4	/wiki/R4:_Ridge_Racer_Type_4

Mega Man 3	/wiki/Mega_Man_3

Toy Story 2: Buzz Lightyear to the Rescue	/wiki/Toy_Story_2:_Buzz_Lightyear_to_the_Rescue

Parasite Eve (video game)	/wiki/Parasite_Eve_(video_game)

Legend of Mana	/wiki/Legend_of_Mana

Dino Crisis 2	/wiki/Dino_Crisis_2

Threads of Fate	/wiki/Threads_of_Fate

Missile Command	/wiki/Missile_Command

Tekken (video game)	/wiki/Tekken_(video_game)

The Rapid Angel (page does not exist)	/w/index.php?title=The_Rapid_Angel&action=edit&redlink=1

Yakiniku Bugyou (page does not exist)	/w/index.php?title=Yakiniku_Bugyou&action=edit&redlink=1

Kyuin (page does not exist)	/w/index.php?title=Kyuin&action=edit&redlink=1

Breath of Fire IV	/wiki/Breath_of_Fire_IV

Parasite Eve II	/wiki/Parasite_Eve_II

Mega Man 4	/wiki/Mega_Man_4

Cyberbots: Full Metal Madness	/wiki/Cyberbots:_Full_Metal_Madness

Pong: The Next Level (page does not exist)	/w/index.php?title=Pong:_The_Next_Level&action=edit&redlink=1

Chrono Trigger	/wiki/Chrono_Trigger

XS Junior League Football (page does not exist)	/w/index.php?title=XS_Junior_League_Football&action=edit&redlink=1

Street Fighter Alpha 3	/wiki/Street_Fighter_Alpha_3

Monster Bass! (page does not exist)	/w/index.php?title=Monster_Bass!&action=edit&redlink=1

Magical Drop	/wiki/Magical_Drop

Dezaemon Kids! (page does not exist)	/w/index.php?title=Dezaemon_Kids!&action=edit&redlink=1

Chrono Cross	/wiki/Chrono_Cross

Vanguard Bandits	/wiki/Vanguard_Bandits

Final Fantasy V	/wiki/Final_Fantasy_V

Darkstalkers: The Night Warriors	/wiki/Darkstalkers:_The_Night_Warriors

Final Fantasy VI	/wiki/Final_Fantasy_VI

Centipede (video game)	/wiki/Centipede_(video_game)

Klonoa: Door to Phantomile	/wiki/Klonoa:_Door_to_Phantomile

Final Fantasy (video game)	/wiki/Final_Fantasy_(video_game)#Versions_and_re-releases

Darkstalkers 3	/wiki/Darkstalkers_3

Future Cop: LAPD	/wiki/Future_Cop:_LAPD

The Legend of Dragoon	/wiki/The_Legend_of_Dragoon

Myst	/wiki/Myst

Alone in the Dark: The New Nightmare	/wiki/Alone_in_the_Dark:_The_New_Nightmare

Tomba!	/wiki/Tomba!

The Little Mermaid II (video game) (page does not exist)	/w/index.php?title=The_Little_Mermaid_II_(video_game)&action=edit&redlink=1

Mickey Mania	/wiki/Mickey_Mania

Turnabout (video game)	/wiki/Turnabout_(video_game)

Art Camion Sugorokuden (page does not exist)	/w/index.php?title=Art_Camion_Sugorokuden&action=edit&redlink=1

Finger Flashing (page does not exist)	/w/index.php?title=Finger_Flashing&action=edit&redlink=1

Lup*Salad (page does not exist)	/w/index.php?title=Lup*Salad&action=edit&redlink=1

Makeruna! Makendō 2: Kimero Youkai Souri	/wiki/Makeruna!_Makend%C5%8D_2:_Kimero_Youkai_Souri

Vehicle Cavalier (page does not exist)	/w/index.php?title=Vehicle_Cavalier&action=edit&redlink=1

Zanac	/wiki/Zanac

Twisted Metal (1995 video game)	/wiki/Twisted_Metal_(1995_video_game)

Persona 2: Eternal Punishment	/wiki/Persona_2:_Eternal_Punishment

Favorite Dear: Enkan no Monogatari (page does not exist)	/w/index.php?title=Favorite_Dear:_Enkan_no_Monogatari&action=edit&redlink=1

First Queen IV (page does not exist)	/w/index.php?title=First_Queen_IV&action=edit&redlink=1

Mahjong Uranai Fortuna: Tsuki no Megami-tachi (page does not exist)	/w/index.php?title=Mahjong_Uranai_Fortuna:_Tsuki_no_Megami-tachi&action=edit&redlink=1

Motorhead (video game)	/wiki/Motorhead_(video_game)

Rung Rung: Oz no Mahou Tsukai - Another World (page does not exist)	/w/index.php?title=Rung_Rung:_Oz_no_Mahou_Tsukai_-_Another_World&action=edit&redlink=1

Sentimental Graffiti	/wiki/Sentimental_Graffiti

Trump Shiyouyo! (Reprint) (page does not exist)	/w/index.php?title=Trump_Shiyouyo!_(Reprint)&action=edit&redlink=1

Hogs of War	/wiki/Hogs_of_War

Evergreen Avenue (page does not exist)	/w/index.php?title=Evergreen_Avenue&action=edit&redlink=1

Favorite Dear: Junshiro no Yogenmono (page does not exist)	/w/index.php?title=Favorite_Dear:_Junshiro_no_Yogenmono&action=edit&redlink=1

Mahjong Youchien: Tamago Gumi (page does not exist)	/w/index.php?title=Mahjong_Youchien:_Tamago_Gumi&action=edit&redlink=1

Mahjong Youchien: Tamago Gumi 2 (page does not exist)	/w/index.php?title=Mahjong_Youchien:_Tamago_Gumi_2&action=edit&redlink=1

Motto Trump Shiyouyo! i-Mode de Grand Prix (page does not exist)	/w/index.php?title=Motto_Trump_Shiyouyo!_i-Mode_de_Grand_Prix&action=edit&redlink=1

Ayumi Kumi (page does not exist)	/w/index.php?title=Ayumi_Kumi&action=edit&redlink=1

Metal Gear Solid: VR Missions	/wiki/Metal_Gear_Solid:_VR_Missions

Double Dragon (Neo-Geo)	/wiki/Double_Dragon_(Neo-Geo)

Lucifer Ring (page does not exist)	/w/index.php?title=Lucifer_Ring&action=edit&redlink=1

Cyber Sled	/wiki/Cyber_Sled

The Firemen	/wiki/The_Firemen

Gex: Enter the Gecko	/wiki/Gex:_Enter_the_Gecko

Pac-Man World	/wiki/Pac-Man_World

Wolf Fang	/wiki/Wolf_Fang

Mr. Driller	/wiki/Mr._Driller

Tomba! 2: The Evil Swine Return	/wiki/Tomba!_2:_The_Evil_Swine_Return

Herc's Adventures	/wiki/Herc%27s_Adventures

Gunship 2000	/wiki/Gunship_2000

TNN Motorsports Hardcore TR (page does not exist)	/w/index.php?title=TNN_Motorsports_Hardcore_TR&action=edit&redlink=1

Hyper Crazy Climber	/wiki/Hyper_Crazy_Climber

Puzzle Bobble 4	/wiki/Puzzle_Bobble_4

Dragon Beat: Legend of Pinball (page does not exist)	/w/index.php?title=Dragon_Beat:_Legend_of_Pinball&action=edit&redlink=1

Dungeon Shoutenkai: Densetsu no Ken Hajimemashita (page does not exist)	/w/index.php?title=Dungeon_Shoutenkai:_Densetsu_no_Ken_Hajimemashita&action=edit&redlink=1

Heroine Dream 2 (page does not exist)	/w/index.php?title=Heroine_Dream_2&action=edit&redlink=1

Neo Planet (page does not exist)	/w/index.php?title=Neo_Planet&action=edit&redlink=1

Tokyo 23-ku Seifuku Wars (page does not exist)	/w/index.php?title=Tokyo_23-ku_Seifuku_Wars&action=edit&redlink=1

Heroine Dream	/wiki/Heroine_Dream

All-Star Slammin' D-Ball (page does not exist)	/w/index.php?title=All-Star_Slammin%27_D-Ball&action=edit&redlink=1

Card Games (video game) (page does not exist)	/w/index.php?title=Card_Games_(video_game)&action=edit&redlink=1

Putter Golf (video game) (page does not exist)	/w/index.php?title=Putter_Golf_(video_game)&action=edit&redlink=1

Mega Man X4	/wiki/Mega_Man_X4

Mega Man X5	/wiki/Mega_Man_X5

Namco Museum Volume 1	/wiki/Namco_Museum_Volume_1

Namco Museum	/wiki/Namco_Museum#Namco_Museum_Volume_2

Namco Museum	/wiki/Namco_Museum#Namco_Museum_Volume_3

Namco Museum Volume 4	/wiki/Namco_Museum_Volume_4

Namco Museum Volume 5	/wiki/Namco_Museum_Volume_5

Strider 2	/wiki/Strider_2

Vib-Ribbon	/wiki/Vib-Ribbon

Kickboxing (video game) (page does not exist)	/w/index.php?title=Kickboxing_(video_game)&action=edit&redlink=1

Boxing (2000 video game) (page does not exist)	/w/index.php?title=Boxing_(2000_video_game)&action=edit&redlink=1

Chess (2001 video game) (page does not exist)	/w/index.php?title=Chess_(2001_video_game)&action=edit&redlink=1

Suikoden II	/wiki/Suikoden_II

Xevious 3D/G	/wiki/Xevious_3D/G

Aces of the Air	/wiki/Aces_of_the_Air

Battle Hunter	/wiki/Battle_Hunter

Echo Night	/wiki/Echo_Night

Armored Core (video game)	/wiki/Armored_Core_(video_game)

Shadow Tower	/wiki/Shadow_Tower

The Misadventures of Tron Bonne	/wiki/The_Misadventures_of_Tron_Bonne

Mega Man 8	/wiki/Mega_Man_8

Crossroad Crisis (page does not exist)	/w/index.php?title=Crossroad_Crisis&action=edit&redlink=1

Shooter: Space Shot	/wiki/Shooter:_Space_Shot

Star Sweep (page does not exist)	/w/index.php?title=Star_Sweep&action=edit&redlink=1

Racing (video game) (page does not exist)	/w/index.php?title=Racing_(video_game)&action=edit&redlink=1

Mega Man Legends (video game)	/wiki/Mega_Man_Legends_(video_game)

Sanvein	/wiki/Sanvein

Street Racquetball (page does not exist)	/w/index.php?title=Street_Racquetball&action=edit&redlink=1

Tecmo's Deception: Invitation to Darkness	/wiki/Tecmo%27s_Deception:_Invitation_to_Darkness

Ms. Pac-Man Maze Madness	/wiki/Ms._Pac-Man_Maze_Madness

